###########################################################################################
#                             #                       #              #           #        #
#  #######  #  ####  #  #############  #  ####  #######  #  ####  ##########  #  #  #  #  #
#  #  #     #     #  #  #        #  #  #  #              #     #           #  #     #  #  #
####  #  ####  #############  ####  #     #  ####  #  #  ###  ########  #  ##########  ####
#  #     #  #        #                          #  #  #           #     #           #  #  #
#  #######  #  #######  ####  #  #  ####  ####  ####  #######  #  #  ##########  ####  #  #
#     #        #           #  #  #        #        #  #     #                             #
####  #  #  ####  #######  ####  #  ####  #######  #  #  #######  #######  #  #######  ####
#        #           #           #     #  #     #  #                       #     #        #
#####   ##  #  ##########  ####  ####  #  #  #  #  #  ####  ####  #############  #  #  #  #
#           #     #        #        #  #                 #     #  #        #  #     #  #  #
####  ###  ##  ####  #### #####  ####  #  ####  ####  #     ####     #  #  #  #  #        #
#     #                 #  #           #  #           #  #        #  #  #     #  #        #
#  ##########  #  #######  #  #######     ####  #  ####  #  #  #  #  #######  #  #  #######
#     #  #     #        #     #        #        #           #  #        #        #        #
#  #  #  #  #######  ####  ####  #  #  ####  ####  ####  #  #  ####  ##   #####     ####  #
#  #     #           #           #  #     #     #     #  #  #        #           #     #  #
#  #######  #######  ####  #  #######  #  ####  #  ####  ####     #  #  #######  #######  #
#     #           #        #           #                 #        #                       #
###########################################################################################