###########################################################################################
#     #           #        #     #  #        #              #  #              #  #  #     #
#  #  #  ####  ####  #  ####  ####  #  ####  ####  #  #  #  #  #  #############  #  #  ####
#  #        #     #  #              #     #  #     #  #     #  #              #  #     #  #
#######  ####  ####  #  ####  ####  #######  #  ####  #  #  #  #  #  #  #  #  #  ####  #  #
#           #  #     #     #  #     #  #  #        #  #           #  #  #  #        #     #
#  #######  #  #  #  #  #  ####  #  #  #  #  ####  #  #   #########  ##########        ####
#        #  #     #  #  #  #  #  #        #  #  #  #           #  #           #  #        #
#  #######  #  ####  #  #  #  ####  ####  ####  ####  #  ####  #  #  #######  #  #  ####  #
#  #           #  #  #  #     #  #     #              #     #  #  #  #     #  #     #  #  #
####  ####  #  #  ####  #  ####  #######  #  ####  #######  #  #  ####  ####  ####  #  #  #
#     #     #  #        #  #     #     #  #     #  #              #  #        #     #     #
####  #  ####  #  #  ####  #  #######  #  #  #  #  ####  #######  #  #  #  #  #######  #  #
#        #        #  #  #  #        #     #  #     #           #     #  #  #        #  #  #
#  #  #  #######  ####  ####  #######  #######  #  ####  #  #  #  #  #  ####  ####  #  ####
#  #  #  #        #  #              #     #     #        #  #  #  #     #     #           #
#######  #  ####  #  #  #  #  #######  #  #######   ###  #  #  #  #  #  #  #  ##########  #
#        #  #        #  #  #  #     #  #  #     #     #  #     #  #  #  #  #     #        #
####  #  #  #  #######  #  #  #  #  ####  ####  #  ####  #  ####  ####  #  #  #  #######  #
#     #                    #     #                       #     #  #           #        #  #
###########################################################################################