###########################################################################################
#                    #     #     #              #  #           #  #  #     #              #
#  ####  #######  #######  ####  #############  #  #  #  #######  #  #  ####  ##########  #
#     #  #  #                          #              #           #                 #     #
#  #  #  #  #  #  ####  #  ##########  #######  #  #############  #  ####  #######  ####  #
#  #  #        #  #     #  #  #                 #     #  #     #        #     #  #  #     #
####  #######  #  #  ####  #  ##########  ####  #  #  #  #  ####  ####  #######  #  #######
#                       #              #  #  #  #  #              #  #     #  #           #
#######  #############  #  ####  #  #### ##  #  ####  #  ####  #  #  ####  #  #  #  #######
#  #           #     #  #        #                          #  #        #        #     #  #
#  ##########  #  #######  ####  ##########  #  ##########  ####  ####  ####  ####  #  #  #
#  #  #  #  #        #     #        #        #  #        #     #  #     #     #     #     #
#  #  #  #  #  ####  ##########  #  #  #######  #######  ####     ################  ####  #
#                 #              #                             #     #        #        #  #
#######  #  ####  #  #  ####  #  ####  ####  #######  ##########  #  ####  ####  #######  #
#              #        #     #  #        #                       #              #        #
#  #  #######  #  #######  #  #     #  ##########  #######  #  #  #######  ####  ####  #  #
#  #        #              #     #  #     #              #  #  #        #              #  #
##########  ####  ####  ####  ####  #  ##########  #############  #  #######  #######  #  #
#           #        #  #        #  #  #                 #                          #  #  #
###########################################################################################